+------------------------------------------------------------------------------------------------------------------------+
|A,B,C                                                                                                                   |
|                                                                                                                        |
|                                                                                                                        |
|                                                                                                                        |
|                                                                                                                        |
|                                                                                                                        |
|                                                                                                                        |
|                                                                                                                        |
|                                                                                                                        |
|                                                                                                                        |
|                                                                                                                        |
|                                                                                                                        |
|                                                                                                                        |
|                                                                                                                        |
|                                                                                                                        |
|                                                                                                                        |
|                                                                                                                        |
|                                                                                                                        |
|                                                                                                                        |
|                                                                                                                        |
|                                                                                                                        |
|                                                                                                                        |
|                                                                                                                        |
|                                                                                                                        |
|                                                                                                                        |
|                                                                                                                        |
|                                                                                                                        |
|                                                                                                                        |
|                                                                                                                        |
|                                                                                                                        |
|                                                                                                                        |
|                                                                                                                        |
|                                                                                                                        |
|                                                                                                                        |
|                                                                                                                        |
|                                                                                                                        |
|                                                                                                                        |
|                                                                                                                        |
|                                                                                                                        |
|                                                                                                                        |
+------------------------------------------------------------------------------------------------------------------------+
