+------------------------------------------------------------------------------------------------------------------------+
|a,b,c                                                                                                                   |
|                                                                                                                        |
|                                                                                                                        |
|                                                                                                                        |
|                                                                                                                        |
|                                                                                                                        |
|                                                                                                                        |
|                                                                                                                        |
|                                                                                                                        |
|                                                                                                                        |
|                                                                                                                        |
|                                                                                                                        |
|                                                                                                                        |
|                                                                                                                        |
|                                                                                                                        |
|                                                                                                                        |
|                                                                                                                        |
|                                                                                                                        |
|                                                                                                                        |
|                                                                                                                        |
|                                                                                                                        |
|                                                                                                                        |
|                                                                                                                        |
|                                                                                                                        |
|                                                                                                                        |
|                                                                                                                        |
|                                                                                                                        |
|                                                                                                                        |
|                                                                                                                        |
|                                                                                                                        |
|                                                                                                                        |
|                                                                                                                        |
|                                                                                                                        |
|                                                                                                                        |
|                                                                                                                        |
|                                                                                                                        |
|                                                                                                                        |
|                                                                                                                        |
|                                                                                                                        |
|                                                                                                                        |
+------------------------------------------------------------------------------------------------------------------------+
